{
    "map":[
        471,471,471,471,471,471,471,471,471,471,471,473,471,471,471,
        471,471,471,471,471,471,471,471,1182,1182,1184,1182,471,
        469,471,471,471,471,1182,1212,1214,1182,471,471,471,471,
        471,471,1183,1213,1215,1185,471,473,471,471,471,471,1182,
        1184,1182,1182,471,471,471,471,471,471,471,471,471,471,471,
        471,471,471,471,475,471,471,471,471,471,471,471,471,475,475,
        471,471,471,471,471,469,471,471,471,471,471,471,471,471,471,471,471
    ],
    "zContent":{
        "1":{"36":17},
        "2":{"45":10},
        "3":{"65":115},
        "4":{"22":67,"31":67,"65":90}
    }
}